REB = "setup/countries/rebels.txt"
PIR = "setup/countries/pirates.txt"
BAR = "setup/countries/barbarians.txt"
MER = "setup/countries/mercenaries.txt"

#Used A,B,C,D,E,F,G,H,I,J,K,L,M,N,O,P,R,S,T,V
#New:
#Alinor Region
AAA = "setup/countries/modded/mAAA.txt"
AAB = "setup/countries/modded/mAAB.txt"
AAC = "setup/countries/modded/mAAC.txt"
AAD = "setup/countries/modded/mAAD.txt"
AAE = "setup/countries/modded/mAAE.txt"
AAF = "setup/countries/modded/mAAF.txt"
AAH = "setup/countries/modded/mAAH.txt"
AAJ = "setup/countries/modded/mAAJ.txt"
AAK = "setup/countries/modded/mAAK.txt"
AAL = "setup/countries/modded/mAAL.txt"
AAM = "setup/countries/modded/mAAM.txt"
AAN = "setup/countries/modded/mAAN.txt"
AAO = "setup/countries/modded/mAAO.txt"
AAP = "setup/countries/modded/mAAP.txt"
AAR = "setup/countries/modded/mAAR.txt"
AAS = "setup/countries/modded/mAAS.txt"
AAT = "setup/countries/modded/mAAT.txt"
AAU = "setup/countries/modded/mAAU.txt"
AAW = "setup/countries/modded/mAAW.txt"
#Cyrodiil Region
CAA = "setup/countries/modded/mCAA.txt"
CAB = "setup/countries/modded/mCAB.txt"
CAC = "setup/countries/modded/mCAC.txt"
CAD = "setup/countries/modded/mCAD.txt"
CAE = "setup/countries/modded/mCAE.txt"
CAF = "setup/countries/modded/mCAF.txt"
CAG = "setup/countries/modded/mCAG.txt"
CAH = "setup/countries/modded/mCAH.txt"
CAI = "setup/countries/modded/mCAI.txt"
CAJ = "setup/countries/modded/mCAJ.txt"
CAK = "setup/countries/modded/mCAK.txt"
CAL = "setup/countries/modded/mCAL.txt"
CAM = "setup/countries/modded/mCAM.txt"
CAN = "setup/countries/modded/mCAN.txt"
CAO = "setup/countries/modded/mCAO.txt"
CAP = "setup/countries/modded/mCAP.txt"
CAR = "setup/countries/modded/mCAR.txt"
CAS = "setup/countries/modded/mCAS.txt"
CAT = "setup/countries/modded/mCAT.txt"
CAU = "setup/countries/modded/mCAU.txt"
CAW = "setup/countries/modded/mCAW.txt"
CAY = "setup/countries/modded/mCAY.txt"
CAZ = "setup/countries/modded/mCAZ.txt"